#####
#                                        #
#                002                     #
#                 |                      #
#                 |                      #
#                001                     #
#                 |                      #
#                 |                      #
#      008--007--000--003--004           #
#                 |                      #
#                 |                      #
#                005                     #
#                 |                      #
#                 |                      #
#                006                     #
#                                        #

#####

LOOP
#####
#                                        #
#                002                     #
#                 |                      #
#                 |                      #
#                001                     #
#                 |                      #
#                 |                      #
#      008--007--000--003--004           #
#       |         |                      #
#       |         |                      #
#      009       005                     #
#       |         |                      #
#       |         |                      #
#      010--011--006                     #
#                                        #

#####

LOOP FORK
#####
#                                        #
#      017       002       014           #
#       |         |         |            #
#       |         |         |            #
#      016--015--001--012--013           #
#                 |                      #
#                 |                      #
#      008--007--000--003--004           #
#       |         |                      #
#       |         |                      #
#      009       005                     #
#       |         |                      #
#       |         |                      #
#      010--011--006                     #
#                                        #

#####


